11111111111111111111111111111111
10P01C00000000000000000001110001
100011100000000000000000VVVV1111
100111000000000000000000000000E1
100010000000000000000000VVVV1111
10000000000000000000000000000001
10000000000000000000000000000001
10000000000000000000000000000001
10000000000000010000000000000001
1000000C000110111000000000000001
10000000000000010000000000000001
10000000000000000000000111111111
10000000000000000000000000011111
10000000000000000000000000001111
10000000000000000000000000000011
10000000000010000000000000000001
10000000000000000000000000C00001
100C0000000000000000000000000001
10000000000000000000000000000001
11111111111111111111111111111111