1111111111111111111111111
100000001C0000000000000E1
10000C0011100000000000001
1000000010000000000000001
1000000010000000000000001
1000000010000000000000001
1000V00010000000000000001
1000000010000000000000001
1000000010000000000000001
10P000000000000000000V001
1000000000000000000000001
1111111111111111111111111