1111111111111111111111111111111
1000000000011110000111000111E11
1111000011000000011110000000011
1000010000010010000000001010101
1P11111010101010101111010110111
1111111111111111111111111111111