1111111111111111111111111111111
1000000000011110000111000111E11
1111100011001100011110000000011
1000010001010010100010101010101
1P11111010101010101111010110111
1111111111111111111111111111111