11111111
1P0000C1
10C000E1
11111111