1111111111111111
10000000100000E1
10000C0010000001
1000000010000001
1000000010000001
1000C00010000001
1000000000000001
100000000C000001
1000000000000001
1P00000000000001
1111111111111111