111111111111111
100001111011111
1E1000000000001
110000000000001
100000000000001
100000000000001
111111111111111