1111111111111111111111111111111111
10000000C0111111111111111110011111
1111110001111111111111111111111111
1000000000000000011111111111111111
1000000000000000000000000000000001
1E000000C0000000000000000000001111
1000000000000000000000000000011111
1000000000000000000000000000010001
1000000000000000000000000000000001
100000000000000000000000C000000001
1000000000000000000000000000000001
110000000000000000000000C000000001
1000000000000000000000000000000001
100000000P000000000000000000000001
1000000000000000000000000000000001
1111111111111111111111111111111111