1111111111111111111111111111111111111111
10000000C0111111111111111110011111111111
1111110001111111111111111111111111111111
1000000000000000011111111111111111111111
1110000000000000000000000000000001111111
1E000000C0000000000000000000001111111111
1000000000000000000000000000011111111111
1000000000000000000000000000010001111111
1000000000000000000000000000000001111111
100000000000000000000000C000000001111111
1000000000000000000000000000000001111111
110000000000000000000000C000000001111111
1000000000000000000000000000000001111111
100000000P000000000000000000000001111111
1000000000000000000000000000000001111111
1111111111111111111111111111111111111111
1111111111111111111111111111111111111111
1111111111111111111111111111111111111111
1111111111111111111111111111111111111111
1111111111111111111111111111111111111111
1111111111111111111111111111111111111111
1111111111111111111111111111111111111111